{
  "field": [
    "#######################",
    "#####.....#####..######",
    "#####.....#####..######",
    "#####.....#####..######",
    "#.....................#",
    "#.....................#",
    "#.....................#",
    "#.....................#",
    "#.....................#",
    "#####.....#####..######",
    "#####.....#####..######",
    "#####.....#####..######",
    "#####.....#####..######",
    "#####.....#####..######",
    "#####.....#####..######",
    "#####.....#####..######",
    "#.....................#",
    "#.....................#",
    "#.....................#",
    "###############..######",
    "###############..######",
    "###############..######",
    "#######################"
  ],

  "field_pedestrian": [
    "#######################",
    "####.#####.###.##.#####",
    "####.#####.###.##.#####",
    "#.....................#",
    "####.#####.###.##.#####",
    "####.#####.###.##.#####",
    "####.#####.###.##.#####",
    "####.#####.###.##.#####",
    "####.#####.###.##.#####",
    "#.....................#",
    "####.#####.###.##.#####",
    "####.#####.###.##.#####",
    "####.#####.###.##.#####",
    "####.#####.###.##.#####",
    "####.#####.###.##.#####",
    "#.....................#",
    "####.#####.###.##.#####",
    "####.#####.###.##.#####",
    "####.#####.###.##.#####",
    "#.....................#",
    "##############.##.#####",
    "##############.##.#####",
    "#######################"
  ],

  "initial_snake_length": 1,
  "max_step_limit": 5000,
  "num_initial_vehicles": 2,
  "num_initial_pedestrians": 6,
  "random_place_snake": 1,
  "rewards": {
    "timestep": 0,
    "good_fruit": 10,
    "correct_accident": 20,
    "bad_fruit": -1,
    "died": -1,
    "lava": -5,
    "violation": -5,
    "accident": -10
  }
}
